1 1 1 1 1
1 3 0 4 1
1 0 9 0 1
1 2 0 5 1
1 1 1 1 1